===== 武侠世界 =====
# Symbols: #=墙 .=草地 ~=水域
#.....~~..........#
#..####.....~~....#
#..................
#...###....##.....#
#..~..........~...#
#..................
#..............##.#
####################
===== 武侠世界 =====